Feature ID	Taxon
Candidatus Nitrososphaera	Archaea;Crenarchaeota;Thaumarchaeota;Nitrososphaerales;Nitrososphaeraceae;Candidatus Nitrososphaera
Methanobrevibacter	Archaea;Euryarchaeota;Methanobacteria;Methanobacteriales;Methanobacteriaceae;Methanobrevibacter
Methanosphaera	Archaea;Euryarchaeota;Methanobacteria;Methanobacteriales;Methanobacteriaceae;Methanosphaera
Methanothermobacter	Archaea;Euryarchaeota;Methanobacteria;Methanobacteriales;Methanobacteriaceae;Methanothermobacter
Methanosarcina	Archaea;Euryarchaeota;Methanomicrobia;Methanosarcinales;Methanosarcinaceae;Methanosarcina
Edaphobacter	Bacteria;Acidobacteria;Acidobacteria (class);Acidobacteriales;Acidobacteriaceae;Edaphobacter
Terriglobus	Bacteria;Acidobacteria;Acidobacteria (class);Acidobacteriales;Acidobacteriaceae;Terriglobus
Candidatus Solibacter	Bacteria;Acidobacteria;Solibacteres;Solibacterales;Solibacteraceae;Candidatus Solibacter
Candidatus Koribacter	Bacteria;Acidobacteria;Unknown;Unknown;Koribacteraceae;Candidatus Koribacter
Actinobaculum	Bacteria;Actinobacteria;Actinobacteria (class);Actinomycetales;Actinomycetaceae;Actinobaculum
Actinomyces	Bacteria;Actinobacteria;Actinobacteria (class);Actinomycetales;Actinomycetaceae;Actinomyces
Arcanobacterium	Bacteria;Actinobacteria;Actinobacteria (class);Actinomycetales;Actinomycetaceae;Arcanobacterium
Mobiluncus	Bacteria;Actinobacteria;Actinobacteria (class);Actinomycetales;Actinomycetaceae;Mobiluncus
Varibaculum	Bacteria;Actinobacteria;Actinobacteria (class);Actinomycetales;Actinomycetaceae;Varibaculum
Actinokineospora	Bacteria;Actinobacteria;Actinobacteria (class);Actinomycetales;Actinosynnemataceae;Actinokineospora
Saccharothrix	Bacteria;Actinobacteria;Actinobacteria (class);Actinomycetales;Actinosynnemataceae;Saccharothrix
Georgenia	Bacteria;Actinobacteria;Actinobacteria (class);Actinomycetales;Bogoriellaceae;Georgenia
Brevibacterium	Bacteria;Actinobacteria;Actinobacteria (class);Actinomycetales;Brevibacteriaceae;Brevibacterium
Actinotalea	Bacteria;Actinobacteria;Actinobacteria (class);Actinomycetales;Cellulomonadaceae;Actinotalea
Cellulomonas	Bacteria;Actinobacteria;Actinobacteria (class);Actinomycetales;Cellulomonadaceae;Cellulomonas
Demequina	Bacteria;Actinobacteria;Actinobacteria (class);Actinomycetales;Cellulomonadaceae;Demequina
Oerskovia	Bacteria;Actinobacteria;Actinobacteria (class);Actinomycetales;Cellulomonadaceae;Oerskovia
Corynebacterium	Bacteria;Actinobacteria;Actinobacteria (class);Actinomycetales;Corynebacteriaceae;Corynebacterium
Cryptosporangium	Bacteria;Actinobacteria;Actinobacteria (class);Actinomycetales;Cryptosporangiaceae;Cryptosporangium
Brachybacterium	Bacteria;Actinobacteria;Actinobacteria (class);Actinomycetales;Dermabacteraceae;Brachybacterium
Dermabacter	Bacteria;Actinobacteria;Actinobacteria (class);Actinomycetales;Dermabacteraceae;Dermabacter
Dermacoccus	Bacteria;Actinobacteria;Actinobacteria (class);Actinomycetales;Dermacoccaceae;Dermacoccus
Kytococcus	Bacteria;Actinobacteria;Actinobacteria (class);Actinomycetales;Dermacoccaceae;Kytococcus
Dermatophilus	Bacteria;Actinobacteria;Actinobacteria (class);Actinomycetales;Dermatophilaceae;Dermatophilus
Dietzia	Bacteria;Actinobacteria;Actinobacteria (class);Actinomycetales;Dietziaceae;Dietzia
Frankia	Bacteria;Actinobacteria;Actinobacteria (class);Actinomycetales;Frankiaceae;Frankia
Geodermatophilus	Bacteria;Actinobacteria;Actinobacteria (class);Actinomycetales;Geodermatophilaceae;Geodermatophilus
Modestobacter	Bacteria;Actinobacteria;Actinobacteria (class);Actinomycetales;Geodermatophilaceae;Modestobacter
Gordonia	Bacteria;Actinobacteria;Actinobacteria (class);Actinomycetales;Gordoniaceae;Gordonia
Arsenicicoccus	Bacteria;Actinobacteria;Actinobacteria (class);Actinomycetales;Intrasporangiaceae;Arsenicicoccus
Janibacter	Bacteria;Actinobacteria;Actinobacteria (class);Actinomycetales;Intrasporangiaceae;Janibacter
Knoellia	Bacteria;Actinobacteria;Actinobacteria (class);Actinomycetales;Intrasporangiaceae;Knoellia
Phycicoccus	Bacteria;Actinobacteria;Actinobacteria (class);Actinomycetales;Intrasporangiaceae;Phycicoccus
Serinicoccus	Bacteria;Actinobacteria;Actinobacteria (class);Actinomycetales;Intrasporangiaceae;Serinicoccus
Terracoccus	Bacteria;Actinobacteria;Actinobacteria (class);Actinomycetales;Intrasporangiaceae;Terracoccus
Tetrasphaera	Bacteria;Actinobacteria;Actinobacteria (class);Actinomycetales;Intrasporangiaceae;Tetrasphaera
Jonesia	Bacteria;Actinobacteria;Actinobacteria (class);Actinomycetales;Jonesiaceae;Jonesia
Kineococcus	Bacteria;Actinobacteria;Actinobacteria (class);Actinomycetales;Kineosporiaceae;Kineococcus
Kineosporia	Bacteria;Actinobacteria;Actinobacteria (class);Actinomycetales;Kineosporiaceae;Kineosporia
Agrococcus	Bacteria;Actinobacteria;Actinobacteria (class);Actinomycetales;Microbacteriaceae;Agrococcus
Agromyces	Bacteria;Actinobacteria;Actinobacteria (class);Actinomycetales;Microbacteriaceae;Agromyces
Clavibacter	Bacteria;Actinobacteria;Actinobacteria (class);Actinomycetales;Microbacteriaceae;Clavibacter
Cryobacterium	Bacteria;Actinobacteria;Actinobacteria (class);Actinomycetales;Microbacteriaceae;Cryobacterium
Cryocola	Bacteria;Actinobacteria;Actinobacteria (class);Actinomycetales;Microbacteriaceae;Cryocola
Curtobacterium	Bacteria;Actinobacteria;Actinobacteria (class);Actinomycetales;Microbacteriaceae;Curtobacterium
Leucobacter	Bacteria;Actinobacteria;Actinobacteria (class);Actinomycetales;Microbacteriaceae;Leucobacter
Microbacterium	Bacteria;Actinobacteria;Actinobacteria (class);Actinomycetales;Microbacteriaceae;Microbacterium
Microcella	Bacteria;Actinobacteria;Actinobacteria (class);Actinomycetales;Microbacteriaceae;Microcella
Pseudoclavibacter	Bacteria;Actinobacteria;Actinobacteria (class);Actinomycetales;Microbacteriaceae;Pseudoclavibacter
Yonghaparkia	Bacteria;Actinobacteria;Actinobacteria (class);Actinomycetales;Microbacteriaceae;Yonghaparkia
Arthrobacter	Bacteria;Actinobacteria;Actinobacteria (class);Actinomycetales;Micrococcaceae;Arthrobacter
Citricoccus	Bacteria;Actinobacteria;Actinobacteria (class);Actinomycetales;Micrococcaceae;Citricoccus
Kocuria	Bacteria;Actinobacteria;Actinobacteria (class);Actinomycetales;Micrococcaceae;Kocuria
Micrococcus	Bacteria;Actinobacteria;Actinobacteria (class);Actinomycetales;Micrococcaceae;Micrococcus
Nesterenkonia	Bacteria;Actinobacteria;Actinobacteria (class);Actinomycetales;Micrococcaceae;Nesterenkonia
Renibacterium	Bacteria;Actinobacteria;Actinobacteria (class);Actinomycetales;Micrococcaceae;Renibacterium
Rothia	Bacteria;Actinobacteria;Actinobacteria (class);Actinomycetales;Micrococcaceae;Rothia
Sinomonas	Bacteria;Actinobacteria;Actinobacteria (class);Actinomycetales;Micrococcaceae;Sinomonas
Actinoplanes	Bacteria;Actinobacteria;Actinobacteria (class);Actinomycetales;Micromonosporaceae;Actinoplanes
Catellatospora	Bacteria;Actinobacteria;Actinobacteria (class);Actinomycetales;Micromonosporaceae;Catellatospora
Dactylosporangium	Bacteria;Actinobacteria;Actinobacteria (class);Actinomycetales;Micromonosporaceae;Dactylosporangium
Luedemannella	Bacteria;Actinobacteria;Actinobacteria (class);Actinomycetales;Micromonosporaceae;Luedemannella
Micromonospora	Bacteria;Actinobacteria;Actinobacteria (class);Actinomycetales;Micromonosporaceae;Micromonospora
Verrucosispora	Bacteria;Actinobacteria;Actinobacteria (class);Actinomycetales;Micromonosporaceae;Verrucosispora
Virgisporangium	Bacteria;Actinobacteria;Actinobacteria (class);Actinomycetales;Micromonosporaceae;Virgisporangium
Mycobacterium	Bacteria;Actinobacteria;Actinobacteria (class);Actinomycetales;Mycobacteriaceae;Mycobacterium
Nocardia	Bacteria;Actinobacteria;Actinobacteria (class);Actinomycetales;Nocardiaceae;Nocardia
Rhodococcus	Bacteria;Actinobacteria;Actinobacteria (class);Actinomycetales;Nocardiaceae;Rhodococcus
Aeromicrobium	Bacteria;Actinobacteria;Actinobacteria (class);Actinomycetales;Nocardioidaceae;Aeromicrobium
Marmoricola	Bacteria;Actinobacteria;Actinobacteria (class);Actinomycetales;Nocardioidaceae;Marmoricola
Nocardioides	Bacteria;Actinobacteria;Actinobacteria (class);Actinomycetales;Nocardioidaceae;Nocardioides
Pimelobacter	Bacteria;Actinobacteria;Actinobacteria (class);Actinomycetales;Nocardioidaceae;Pimelobacter
Propionicimonas	Bacteria;Actinobacteria;Actinobacteria (class);Actinomycetales;Nocardioidaceae;Propionicimonas
Nocardiopsis	Bacteria;Actinobacteria;Actinobacteria (class);Actinomycetales;Nocardiopsaceae;Nocardiopsis
Cellulosimicrobium	Bacteria;Actinobacteria;Actinobacteria (class);Actinomycetales;Promicromonosporaceae;Cellulosimicrobium
Isoptericola	Bacteria;Actinobacteria;Actinobacteria (class);Actinomycetales;Promicromonosporaceae;Isoptericola
Myceligenerans	Bacteria;Actinobacteria;Actinobacteria (class);Actinomycetales;Promicromonosporaceae;Myceligenerans
Propionibacterium	Bacteria;Actinobacteria;Actinobacteria (class);Actinomycetales;Propionibacteriaceae;Propionibacterium
Tessaracoccus	Bacteria;Actinobacteria;Actinobacteria (class);Actinomycetales;Propionibacteriaceae;Tessaracoccus
Actinoalloteichus	Bacteria;Actinobacteria;Actinobacteria (class);Actinomycetales;Pseudonocardiaceae;Actinoalloteichus
Actinomycetospora	Bacteria;Actinobacteria;Actinobacteria (class);Actinomycetales;Pseudonocardiaceae;Actinomycetospora
Amycolatopsis	Bacteria;Actinobacteria;Actinobacteria (class);Actinomycetales;Pseudonocardiaceae;Amycolatopsis
Crossiella	Bacteria;Actinobacteria;Actinobacteria (class);Actinomycetales;Pseudonocardiaceae;Crossiella
Goodfellowiella	Bacteria;Actinobacteria;Actinobacteria (class);Actinomycetales;Pseudonocardiaceae;Goodfellowiella
Jiangella	Bacteria;Actinobacteria;Actinobacteria (class);Actinomycetales;Pseudonocardiaceae;Jiangella
Pseudonocardia	Bacteria;Actinobacteria;Actinobacteria (class);Actinomycetales;Pseudonocardiaceae;Pseudonocardia
Saccharopolyspora	Bacteria;Actinobacteria;Actinobacteria (class);Actinomycetales;Pseudonocardiaceae;Saccharopolyspora
Sporichthya	Bacteria;Actinobacteria;Actinobacteria (class);Actinomycetales;Sporichthyaceae;Sporichthya
Streptomyces	Bacteria;Actinobacteria;Actinobacteria (class);Actinomycetales;Streptomycetaceae;Streptomyces
Microbispora	Bacteria;Actinobacteria;Actinobacteria (class);Actinomycetales;Streptosporangiaceae;Microbispora
Microtetraspora	Bacteria;Actinobacteria;Actinobacteria (class);Actinomycetales;Streptosporangiaceae;Microtetraspora
Nonomuraea	Bacteria;Actinobacteria;Actinobacteria (class);Actinomycetales;Streptosporangiaceae;Nonomuraea
Sphaerisporangium	Bacteria;Actinobacteria;Actinobacteria (class);Actinomycetales;Streptosporangiaceae;Sphaerisporangium
Streptosporangium	Bacteria;Actinobacteria;Actinobacteria (class);Actinomycetales;Streptosporangiaceae;Streptosporangium
Actinoallomurus	Bacteria;Actinobacteria;Actinobacteria (class);Actinomycetales;Thermomonosporaceae;Actinoallomurus
Actinocorallia	Bacteria;Actinobacteria;Actinobacteria (class);Actinomycetales;Thermomonosporaceae;Actinocorallia
Actinomadura	Bacteria;Actinobacteria;Actinobacteria (class);Actinomycetales;Thermomonosporaceae;Actinomadura
Thermomonospora	Bacteria;Actinobacteria;Actinobacteria (class);Actinomycetales;Thermomonosporaceae;Thermomonospora
Tsukamurella	Bacteria;Actinobacteria;Actinobacteria (class);Actinomycetales;Tsukamurellaceae;Tsukamurella
Tropheryma	Bacteria;Actinobacteria;Actinobacteria (class);Actinomycetales;Unknown;Tropheryma
Williamsia	Bacteria;Actinobacteria;Actinobacteria (class);Actinomycetales;Williamsiaceae;Williamsia
Alloscardovia	Bacteria;Actinobacteria;Actinobacteria (class);Bifidobacteriales;Bifidobacteriaceae;Alloscardovia
Bifidobacterium	Bacteria;Actinobacteria;Actinobacteria (class);Bifidobacteriales;Bifidobacteriaceae;Bifidobacterium
Gardnerella	Bacteria;Actinobacteria;Actinobacteria (class);Bifidobacteriales;Bifidobacteriaceae;Gardnerella
Parascardovia	Bacteria;Actinobacteria;Actinobacteria (class);Bifidobacteriales;Bifidobacteriaceae;Parascardovia
Scardovia	Bacteria;Actinobacteria;Actinobacteria (class);Bifidobacteriales;Bifidobacteriaceae;Scardovia
Adlercreutzia	Bacteria;Actinobacteria;Actinobacteria (class);Coriobacteriales;Coriobacteriaceae;Adlercreutzia
Atopobium	Bacteria;Actinobacteria;Actinobacteria (class);Coriobacteriales;Coriobacteriaceae;Atopobium
Collinsella	Bacteria;Actinobacteria;Actinobacteria (class);Coriobacteriales;Coriobacteriaceae;Collinsella
Coriobacterium	Bacteria;Actinobacteria;Actinobacteria (class);Coriobacteriales;Coriobacteriaceae;Coriobacterium
Eggerthella	Bacteria;Actinobacteria;Actinobacteria (class);Coriobacteriales;Coriobacteriaceae;Eggerthella
Olsenella	Bacteria;Actinobacteria;Actinobacteria (class);Coriobacteriales;Coriobacteriaceae;Olsenella
Slackia	Bacteria;Actinobacteria;Actinobacteria (class);Coriobacteriales;Coriobacteriaceae;Slackia
Rubrobacter	Bacteria;Actinobacteria;Actinobacteria (class);Rubrobacterales;Rubrobacteraceae;Rubrobacter
Patulibacter	Bacteria;Actinobacteria;Actinobacteria (class);Solirubrobacterales;Patulibacteraceae;Patulibacter
Bacteria_Bacteroidetes_Bacteroidia_Bacteroidales_Bacteroidaceae_Bacteroides	Bacteria;Bacteroidetes;Bacteroidia;Bacteroidales;Bacteroidaceae;Bacteroides
Dysgonomonas	Bacteria;Bacteroidetes;Bacteroidia;Bacteroidales;Porphyromonadaceae;Dysgonomonas
Odoribacter	Bacteria;Bacteroidetes;Bacteroidia;Bacteroidales;Porphyromonadaceae;Odoribacter
Paludibacter	Bacteria;Bacteroidetes;Bacteroidia;Bacteroidales;Porphyromonadaceae;Paludibacter
Parabacteroides	Bacteria;Bacteroidetes;Bacteroidia;Bacteroidales;Porphyromonadaceae;Parabacteroides
Porphyromonas	Bacteria;Bacteroidetes;Bacteroidia;Bacteroidales;Porphyromonadaceae;Porphyromonas
Tannerella	Bacteria;Bacteroidetes;Bacteroidia;Bacteroidales;Porphyromonadaceae;Tannerella
Prevotella	Bacteria;Bacteroidetes;Bacteroidia;Bacteroidales;Prevotellaceae;Prevotella
Alistipes	Bacteria;Bacteroidetes;Bacteroidia;Bacteroidales;Rikenellaceae;Alistipes
Candidatus Azobacteroides	Bacteria;Bacteroidetes;Bacteroidia;Bacteroidales;Unknown;Candidatus Azobacteroides
Capnocytophaga	Bacteria;Bacteroidetes;Flavobacteria;Flavobacteriales;Flavobacteriaceae;Capnocytophaga
Chryseobacterium	Bacteria;Bacteroidetes;Flavobacteria;Flavobacteriales;Flavobacteriaceae;Chryseobacterium
Elizabethkingia	Bacteria;Bacteroidetes;Flavobacteria;Flavobacteriales;Flavobacteriaceae;Elizabethkingia
Flavobacterium	Bacteria;Bacteroidetes;Flavobacteria;Flavobacteriales;Flavobacteriaceae;Flavobacterium
Gelidibacter	Bacteria;Bacteroidetes;Flavobacteria;Flavobacteriales;Flavobacteriaceae;Gelidibacter
Kaistella	Bacteria;Bacteroidetes;Flavobacteria;Flavobacteriales;Flavobacteriaceae;Kaistella
Sejongia	Bacteria;Bacteroidetes;Flavobacteria;Flavobacteriales;Flavobacteriaceae;Sejongia
Wautersiella	Bacteria;Bacteroidetes;Flavobacteria;Flavobacteriales;Flavobacteriaceae;Wautersiella
Algoriphagus	Bacteria;Bacteroidetes;Sphingobacteria;Sphingobacteriales;Cyclobacteriaceae;Algoriphagus
Aquiflexum	Bacteria;Bacteroidetes;Sphingobacteria;Sphingobacteriales;Cyclobacteriaceae;Aquiflexum
Belliella	Bacteria;Bacteroidetes;Sphingobacteria;Sphingobacteriales;Cyclobacteriaceae;Belliella
Cyclobacterium	Bacteria;Bacteroidetes;Sphingobacteria;Sphingobacteriales;Cyclobacteriaceae;Cyclobacterium
Echinicola	Bacteria;Bacteroidetes;Sphingobacteria;Sphingobacteriales;Cyclobacteriaceae;Echinicola
Adhaeribacter	Bacteria;Bacteroidetes;Sphingobacteria;Sphingobacteriales;Flexibacteraceae;Adhaeribacter
Cytophaga	Bacteria;Bacteroidetes;Sphingobacteria;Sphingobacteriales;Flexibacteraceae;Cytophaga
Dyadobacter	Bacteria;Bacteroidetes;Sphingobacteria;Sphingobacteriales;Flexibacteraceae;Dyadobacter
Emticicia	Bacteria;Bacteroidetes;Sphingobacteria;Sphingobacteriales;Flexibacteraceae;Emticicia
Flectobacillus	Bacteria;Bacteroidetes;Sphingobacteria;Sphingobacteriales;Flexibacteraceae;Flectobacillus
Hymenobacter	Bacteria;Bacteroidetes;Sphingobacteria;Sphingobacteriales;Flexibacteraceae;Hymenobacter
Pontibacter	Bacteria;Bacteroidetes;Sphingobacteria;Sphingobacteriales;Flexibacteraceae;Pontibacter
Salinibacter	Bacteria;Bacteroidetes;Sphingobacteria;Sphingobacteriales;Rhodothermaceae;Salinibacter
Haliscomenobacter	Bacteria;Bacteroidetes;Sphingobacteria;Sphingobacteriales;Saprospiraceae;Haliscomenobacter
Parapedobacter	Bacteria;Bacteroidetes;Sphingobacteria;Sphingobacteriales;Sphingobacteriaceae;Parapedobacter
Pedobacter	Bacteria;Bacteroidetes;Sphingobacteria;Sphingobacteriales;Sphingobacteriaceae;Pedobacter
Sphingobacterium	Bacteria;Bacteroidetes;Sphingobacteria;Sphingobacteriales;Sphingobacteriaceae;Sphingobacterium
Chitinophaga	Bacteria;Bacteroidetes;Sphingobacteria;Sphingobacteriales;Unknown;Chitinophaga
Flavisolibacter	Bacteria;Bacteroidetes;Sphingobacteria;Sphingobacteriales;Unknown;Flavisolibacter
Segetibacter	Bacteria;Bacteroidetes;Sphingobacteria;Sphingobacteriales;Unknown;Segetibacter
Candidatus Amoebophilus	Bacteria;Bacteroidetes;Unknown;Unknown;Unknown;Candidatus Amoebophilus
Chlamydia	Bacteria;Chlamydiae;Chlamydiae (class);Chlamydiales;Chlamydiaceae;Chlamydia
Caldilinea	Bacteria;Chloroflexi;Anaerolineae;Caldilineales;Caldilineaceae;Caldilinea
Herpetosiphon	Bacteria;Chloroflexi;Chloroflexi (class);Herpetosiphonales;Herpetosiphonaceae;Herpetosiphon
Kouleothrix	Bacteria;Chloroflexi;Chloroflexi (class);Roseiflexales;Kouleothrixaceae;Kouleothrix
Gloeotrichia	Bacteria;Cyanobacteria;Unknown;Nostocales;Nostocaceae;Gloeotrichia
Nostoc	Bacteria;Cyanobacteria;Unknown;Nostocales;Nostocaceae;Nostoc
Sphaerospermopsis	Bacteria;Cyanobacteria;Unknown;Nostocales;Nostocaceae;Sphaerospermopsis
Calothrix	Bacteria;Cyanobacteria;Unknown;Nostocales;Rivulariaceae;Calothrix
Brasilonema	Bacteria;Cyanobacteria;Unknown;Nostocales;Scytonemataceae;Brasilonema
Leptolyngbya	Bacteria;Cyanobacteria;Unknown;Oscillatoriales;Unknown;Leptolyngbya
Microcoleus	Bacteria;Cyanobacteria;Unknown;Oscillatoriales;Unknown;Microcoleus
Phormidium	Bacteria;Cyanobacteria;Unknown;Oscillatoriales;Unknown;Phormidium
E4	Bacteria;Deferribacteres;Deferribacteres (class);Deferribacterales;Deferribacteraceae;E4
Mucispirillum	Bacteria;Deferribacteres;Deferribacteres (class);Deferribacterales;Deferribacteraceae;Mucispirillum
Alicyclobacillus	Bacteria;Firmicutes;Bacilli;Bacillales;Alicyclobacillaceae;Alicyclobacillus
Alkalibacillus	Bacteria;Firmicutes;Bacilli;Bacillales;Bacillaceae;Alkalibacillus
Anaerobacillus	Bacteria;Firmicutes;Bacilli;Bacillales;Bacillaceae;Anaerobacillus
Anoxybacillus	Bacteria;Firmicutes;Bacilli;Bacillales;Bacillaceae;Anoxybacillus
Bacteria_Firmicutes_Bacilli_Bacillales_Bacillaceae_Bacillus	Bacteria;Firmicutes;Bacilli;Bacillales;Bacillaceae;Bacillus
Geobacillus	Bacteria;Firmicutes;Bacilli;Bacillales;Bacillaceae;Geobacillus
Halobacillus	Bacteria;Firmicutes;Bacilli;Bacillales;Bacillaceae;Halobacillus
Halolactibacillus	Bacteria;Firmicutes;Bacilli;Bacillales;Bacillaceae;Halolactibacillus
Lentibacillus	Bacteria;Firmicutes;Bacilli;Bacillales;Bacillaceae;Lentibacillus
Natronobacillus	Bacteria;Firmicutes;Bacilli;Bacillales;Bacillaceae;Natronobacillus
Oceanobacillus	Bacteria;Firmicutes;Bacilli;Bacillales;Bacillaceae;Oceanobacillus
Piscibacillus	Bacteria;Firmicutes;Bacilli;Bacillales;Bacillaceae;Piscibacillus
Pontibacillus	Bacteria;Firmicutes;Bacilli;Bacillales;Bacillaceae;Pontibacillus
Salimicrobium	Bacteria;Firmicutes;Bacilli;Bacillales;Bacillaceae;Salimicrobium
Salinibacillus	Bacteria;Firmicutes;Bacilli;Bacillales;Bacillaceae;Salinibacillus
Sediminibacillus	Bacteria;Firmicutes;Bacilli;Bacillales;Bacillaceae;Sediminibacillus
Terribacillus	Bacteria;Firmicutes;Bacilli;Bacillales;Bacillaceae;Terribacillus
Thalassobacillus	Bacteria;Firmicutes;Bacilli;Bacillales;Bacillaceae;Thalassobacillus
Virgibacillus	Bacteria;Firmicutes;Bacilli;Bacillales;Bacillaceae;Virgibacillus
Listeria	Bacteria;Firmicutes;Bacilli;Bacillales;Listeriaceae;Listeria
Ammoniphilus	Bacteria;Firmicutes;Bacilli;Bacillales;Paenibacillaceae;Ammoniphilus
Aneurinibacillus	Bacteria;Firmicutes;Bacilli;Bacillales;Paenibacillaceae;Aneurinibacillus
Brevibacillus	Bacteria;Firmicutes;Bacilli;Bacillales;Paenibacillaceae;Brevibacillus
Cohnella	Bacteria;Firmicutes;Bacilli;Bacillales;Paenibacillaceae;Cohnella
Paenibacillus	Bacteria;Firmicutes;Bacilli;Bacillales;Paenibacillaceae;Paenibacillus
Thermobacillus	Bacteria;Firmicutes;Bacilli;Bacillales;Paenibacillaceae;Thermobacillus
Bacteria_Firmicutes_Bacilli_Bacillales_Planococcaceae_Bacillus	Bacteria;Firmicutes;Bacilli;Bacillales;Planococcaceae;Bacillus
Kurthia	Bacteria;Firmicutes;Bacilli;Bacillales;Planococcaceae;Kurthia
Lysinibacillus	Bacteria;Firmicutes;Bacilli;Bacillales;Planococcaceae;Lysinibacillus
Marinibacillus	Bacteria;Firmicutes;Bacilli;Bacillales;Planococcaceae;Marinibacillus
Planococcus	Bacteria;Firmicutes;Bacilli;Bacillales;Planococcaceae;Planococcus
Planomicrobium	Bacteria;Firmicutes;Bacilli;Bacillales;Planococcaceae;Planomicrobium
Rummeliibacillus	Bacteria;Firmicutes;Bacilli;Bacillales;Planococcaceae;Rummeliibacillus
Solibacillus	Bacteria;Firmicutes;Bacilli;Bacillales;Planococcaceae;Solibacillus
Sporosarcina	Bacteria;Firmicutes;Bacilli;Bacillales;Planococcaceae;Sporosarcina
Ureibacillus	Bacteria;Firmicutes;Bacilli;Bacillales;Planococcaceae;Ureibacillus
Viridibacillus	Bacteria;Firmicutes;Bacilli;Bacillales;Planococcaceae;Viridibacillus
Sporolactobacillus	Bacteria;Firmicutes;Bacilli;Bacillales;Sporolactobacillaceae;Sporolactobacillus
Jeotgalicoccus	Bacteria;Firmicutes;Bacilli;Bacillales;Staphylococcaceae;Jeotgalicoccus
Macrococcus	Bacteria;Firmicutes;Bacilli;Bacillales;Staphylococcaceae;Macrococcus
Salinicoccus	Bacteria;Firmicutes;Bacilli;Bacillales;Staphylococcaceae;Salinicoccus
Staphylococcus	Bacteria;Firmicutes;Bacilli;Bacillales;Staphylococcaceae;Staphylococcus
Laceyella	Bacteria;Firmicutes;Bacilli;Bacillales;Thermoactinomycetaceae;Laceyella
Mechercharimyces	Bacteria;Firmicutes;Bacilli;Bacillales;Thermoactinomycetaceae;Mechercharimyces
Planifilum	Bacteria;Firmicutes;Bacilli;Bacillales;Thermoactinomycetaceae;Planifilum
Shimazuella	Bacteria;Firmicutes;Bacilli;Bacillales;Thermoactinomycetaceae;Shimazuella
Thermoactinomyces	Bacteria;Firmicutes;Bacilli;Bacillales;Thermoactinomycetaceae;Thermoactinomyces
Exiguobacterium	Bacteria;Firmicutes;Bacilli;Bacillales;Unknown;Exiguobacterium
Gemella	Bacteria;Firmicutes;Bacilli;Bacillales;Unknown;Gemella
Pullulanibacillus	Bacteria;Firmicutes;Bacilli;Bacillales;Unknown;Pullulanibacillus
Haloplasma	Bacteria;Firmicutes;Bacilli;Erysipelotrichales;Erysipelotrichaceae;Haloplasma
Turicibacter	Bacteria;Firmicutes;Bacilli;Erysipelotrichales;Erysipelotrichaceae;Turicibacter
Abiotrophia	Bacteria;Firmicutes;Bacilli;Lactobacillales;Aerococcaceae;Abiotrophia
Aerococcus	Bacteria;Firmicutes;Bacilli;Lactobacillales;Aerococcaceae;Aerococcus
Facklamia	Bacteria;Firmicutes;Bacilli;Lactobacillales;Aerococcaceae;Facklamia
Alkalibacterium	Bacteria;Firmicutes;Bacilli;Lactobacillales;Carnobacteriaceae;Alkalibacterium
Alloiococcus	Bacteria;Firmicutes;Bacilli;Lactobacillales;Carnobacteriaceae;Alloiococcus
Carnobacterium	Bacteria;Firmicutes;Bacilli;Lactobacillales;Carnobacteriaceae;Carnobacterium
Desemzia	Bacteria;Firmicutes;Bacilli;Lactobacillales;Carnobacteriaceae;Desemzia
Granulicatella	Bacteria;Firmicutes;Bacilli;Lactobacillales;Carnobacteriaceae;Granulicatella
Trichococcus	Bacteria;Firmicutes;Bacilli;Lactobacillales;Carnobacteriaceae;Trichococcus
Enterococcus	Bacteria;Firmicutes;Bacilli;Lactobacillales;Enterococcaceae;Enterococcus
Melissococcus	Bacteria;Firmicutes;Bacilli;Lactobacillales;Enterococcaceae;Melissococcus
Tetragenococcus	Bacteria;Firmicutes;Bacilli;Lactobacillales;Enterococcaceae;Tetragenococcus
Vagococcus	Bacteria;Firmicutes;Bacilli;Lactobacillales;Enterococcaceae;Vagococcus
Lactobacillus	Bacteria;Firmicutes;Bacilli;Lactobacillales;Lactobacillaceae;Lactobacillus
Pediococcus	Bacteria;Firmicutes;Bacilli;Lactobacillales;Lactobacillaceae;Pediococcus
Fructobacillus	Bacteria;Firmicutes;Bacilli;Lactobacillales;Leuconostocaceae;Fructobacillus
Leuconostoc	Bacteria;Firmicutes;Bacilli;Lactobacillales;Leuconostocaceae;Leuconostoc
Oenococcus	Bacteria;Firmicutes;Bacilli;Lactobacillales;Leuconostocaceae;Oenococcus
Weissella	Bacteria;Firmicutes;Bacilli;Lactobacillales;Leuconostocaceae;Weissella
Lactococcus	Bacteria;Firmicutes;Bacilli;Lactobacillales;Streptococcaceae;Lactococcus
Streptococcus	Bacteria;Firmicutes;Bacilli;Lactobacillales;Streptococcaceae;Streptococcus
Thermicanus	Bacteria;Firmicutes;Bacilli;Unknown;Unknown;Thermicanus
Alkaliphilus	Bacteria;Firmicutes;Clostridia;Clostridiales;Clostridiaceae;Alkaliphilus
Caloramator	Bacteria;Firmicutes;Clostridia;Clostridiales;Clostridiaceae;Caloramator
Bacteria_Firmicutes_Clostridia_Clostridiales_Clostridiaceae_Clostridium	Bacteria;Firmicutes;Clostridia;Clostridiales;Clostridiaceae;Clostridium
Sarcina	Bacteria;Firmicutes;Clostridia;Clostridiales;Clostridiaceae;Sarcina
Anaerococcus	Bacteria;Firmicutes;Clostridia;Clostridiales;Clostridiales Family XI. Incertae Sedis;Anaerococcus
Finegoldia	Bacteria;Firmicutes;Clostridia;Clostridiales;Clostridiales Family XI. Incertae Sedis;Finegoldia
Helcococcus	Bacteria;Firmicutes;Clostridia;Clostridiales;Clostridiales Family XI. Incertae Sedis;Helcococcus
Peptoniphilus	Bacteria;Firmicutes;Clostridia;Clostridiales;Clostridiales Family XI. Incertae Sedis;Peptoniphilus
Sedimentibacter	Bacteria;Firmicutes;Clostridia;Clostridiales;Clostridiales Family XI. Incertae Sedis;Sedimentibacter
Sporanaerobacter	Bacteria;Firmicutes;Clostridia;Clostridiales;Clostridiales Family XI. Incertae Sedis;Sporanaerobacter
Tepidimicrobium	Bacteria;Firmicutes;Clostridia;Clostridiales;Clostridiales Family XI. Incertae Sedis;Tepidimicrobium
Tissierella	Bacteria;Firmicutes;Clostridia;Clostridiales;Clostridiales Family XI. Incertae Sedis;Tissierella
Fusibacter	Bacteria;Firmicutes;Clostridia;Clostridiales;Clostridiales Family XII. Incertae Sedis;Fusibacter
Anaerovorax	Bacteria;Firmicutes;Clostridia;Clostridiales;Clostridiales Family XIII. Incertae Sedis;Anaerovorax
Bacteria_Firmicutes_Clostridia_Clostridiales_Clostridiales Family XIII. Incertae Sedis_Eubacterium	Bacteria;Firmicutes;Clostridia;Clostridiales;Clostridiales Family XIII. Incertae Sedis;Eubacterium
Mogibacterium	Bacteria;Firmicutes;Clostridia;Clostridiales;Clostridiales Family XIII. Incertae Sedis;Mogibacterium
Dehalobacterium	Bacteria;Firmicutes;Clostridia;Clostridiales;Dehalobacteriaceae;Dehalobacterium
Acetobacterium	Bacteria;Firmicutes;Clostridia;Clostridiales;Eubacteriaceae;Acetobacterium
Anaerofustis	Bacteria;Firmicutes;Clostridia;Clostridiales;Eubacteriaceae;Anaerofustis
Bacteria_Firmicutes_Clostridia_Clostridiales_Eubacteriaceae_Eubacterium	Bacteria;Firmicutes;Clostridia;Clostridiales;Eubacteriaceae;Eubacterium
Pseudoramibacter	Bacteria;Firmicutes;Clostridia;Clostridiales;Eubacteriaceae;Pseudoramibacter
Anaerostipes	Bacteria;Firmicutes;Clostridia;Clostridiales;Lachnospiraceae;Anaerostipes
Bacteria_Firmicutes_Clostridia_Clostridiales_Lachnospiraceae_Bacteroides	Bacteria;Firmicutes;Clostridia;Clostridiales;Lachnospiraceae;Bacteroides
Blautia	Bacteria;Firmicutes;Clostridia;Clostridiales;Lachnospiraceae;Blautia
Butyrivibrio	Bacteria;Firmicutes;Clostridia;Clostridiales;Lachnospiraceae;Butyrivibrio
Catonella	Bacteria;Firmicutes;Clostridia;Clostridiales;Lachnospiraceae;Catonella
Bacteria_Firmicutes_Clostridia_Clostridiales_Lachnospiraceae_Clostridium	Bacteria;Firmicutes;Clostridia;Clostridiales;Lachnospiraceae;Clostridium
Coprococcus	Bacteria;Firmicutes;Clostridia;Clostridiales;Lachnospiraceae;Coprococcus
Dorea	Bacteria;Firmicutes;Clostridia;Clostridiales;Lachnospiraceae;Dorea
Epulopiscium	Bacteria;Firmicutes;Clostridia;Clostridiales;Lachnospiraceae;Epulopiscium
Bacteria_Firmicutes_Clostridia_Clostridiales_Lachnospiraceae_Eubacterium	Bacteria;Firmicutes;Clostridia;Clostridiales;Lachnospiraceae;Eubacterium
Johnsonella	Bacteria;Firmicutes;Clostridia;Clostridiales;Lachnospiraceae;Johnsonella
Lachnobacterium	Bacteria;Firmicutes;Clostridia;Clostridiales;Lachnospiraceae;Lachnobacterium
Lachnospira	Bacteria;Firmicutes;Clostridia;Clostridiales;Lachnospiraceae;Lachnospira
Moryella	Bacteria;Firmicutes;Clostridia;Clostridiales;Lachnospiraceae;Moryella
Oribacterium	Bacteria;Firmicutes;Clostridia;Clostridiales;Lachnospiraceae;Oribacterium
Pseudobutyrivibrio	Bacteria;Firmicutes;Clostridia;Clostridiales;Lachnospiraceae;Pseudobutyrivibrio
Roseburia	Bacteria;Firmicutes;Clostridia;Clostridiales;Lachnospiraceae;Roseburia
Bacteria_Firmicutes_Clostridia_Clostridiales_Lachnospiraceae_Ruminococcus	Bacteria;Firmicutes;Clostridia;Clostridiales;Lachnospiraceae;Ruminococcus
Shuttleworthia	Bacteria;Firmicutes;Clostridia;Clostridiales;Lachnospiraceae;Shuttleworthia
Dehalobacter	Bacteria;Firmicutes;Clostridia;Clostridiales;Peptococcaceae;Dehalobacter
Desulfitobacterium	Bacteria;Firmicutes;Clostridia;Clostridiales;Peptococcaceae;Desulfitobacterium
Desulfosporosinus	Bacteria;Firmicutes;Clostridia;Clostridiales;Peptococcaceae;Desulfosporosinus
Desulfotomaculum	Bacteria;Firmicutes;Clostridia;Clostridiales;Peptococcaceae;Desulfotomaculum
Pelotomaculum	Bacteria;Firmicutes;Clostridia;Clostridiales;Peptococcaceae;Pelotomaculum
Peptococcus	Bacteria;Firmicutes;Clostridia;Clostridiales;Peptococcaceae;Peptococcus
Thermincola	Bacteria;Firmicutes;Clostridia;Clostridiales;Peptococcaceae;Thermincola
Filifactor	Bacteria;Firmicutes;Clostridia;Clostridiales;Peptostreptococcaceae;Filifactor
Peptostreptococcus	Bacteria;Firmicutes;Clostridia;Clostridiales;Peptostreptococcaceae;Peptostreptococcus
Tepidibacter	Bacteria;Firmicutes;Clostridia;Clostridiales;Peptostreptococcaceae;Tepidibacter
Acetivibrio	Bacteria;Firmicutes;Clostridia;Clostridiales;Ruminococcaceae;Acetivibrio
Anaerotruncus	Bacteria;Firmicutes;Clostridia;Clostridiales;Ruminococcaceae;Anaerotruncus
Bacteria_Firmicutes_Clostridia_Clostridiales_Ruminococcaceae_Bacteroides	Bacteria;Firmicutes;Clostridia;Clostridiales;Ruminococcaceae;Bacteroides
Bacteria_Firmicutes_Clostridia_Clostridiales_Ruminococcaceae_Clostridium	Bacteria;Firmicutes;Clostridia;Clostridiales;Ruminococcaceae;Clostridium
Ethanoligenens	Bacteria;Firmicutes;Clostridia;Clostridiales;Ruminococcaceae;Ethanoligenens
Bacteria_Firmicutes_Clostridia_Clostridiales_Ruminococcaceae_Eubacterium	Bacteria;Firmicutes;Clostridia;Clostridiales;Ruminococcaceae;Eubacterium
Faecalibacterium	Bacteria;Firmicutes;Clostridia;Clostridiales;Ruminococcaceae;Faecalibacterium
Oscillospira	Bacteria;Firmicutes;Clostridia;Clostridiales;Ruminococcaceae;Oscillospira
Bacteria_Firmicutes_Clostridia_Clostridiales_Ruminococcaceae_Ruminococcus	Bacteria;Firmicutes;Clostridia;Clostridiales;Ruminococcaceae;Ruminococcus
Subdoligranulum	Bacteria;Firmicutes;Clostridia;Clostridiales;Ruminococcaceae;Subdoligranulum
Symbiobacterium	Bacteria;Firmicutes;Clostridia;Clostridiales;Symbiobacteriaceae;Symbiobacterium
Syntrophomonas	Bacteria;Firmicutes;Clostridia;Clostridiales;Syntrophomonadaceae;Syntrophomonas
Thermoanaerobacterium	Bacteria;Firmicutes;Clostridia;Clostridiales;Thermoanaerobacterales Family III. Incertae Sedis;Thermoanaerobacterium
Acidaminococcus	Bacteria;Firmicutes;Clostridia;Clostridiales;Veillonellaceae;Acidaminococcus
Anaeroglobus	Bacteria;Firmicutes;Clostridia;Clostridiales;Veillonellaceae;Anaeroglobus
Desulfosporomusa	Bacteria;Firmicutes;Clostridia;Clostridiales;Veillonellaceae;Desulfosporomusa
Dialister	Bacteria;Firmicutes;Clostridia;Clostridiales;Veillonellaceae;Dialister
Megamonas	Bacteria;Firmicutes;Clostridia;Clostridiales;Veillonellaceae;Megamonas
Megasphaera	Bacteria;Firmicutes;Clostridia;Clostridiales;Veillonellaceae;Megasphaera
Mitsuokella	Bacteria;Firmicutes;Clostridia;Clostridiales;Veillonellaceae;Mitsuokella
Pectinatus	Bacteria;Firmicutes;Clostridia;Clostridiales;Veillonellaceae;Pectinatus
Phascolarctobacterium	Bacteria;Firmicutes;Clostridia;Clostridiales;Veillonellaceae;Phascolarctobacterium
Selenomonas	Bacteria;Firmicutes;Clostridia;Clostridiales;Veillonellaceae;Selenomonas
Sporotalea	Bacteria;Firmicutes;Clostridia;Clostridiales;Veillonellaceae;Sporotalea
Veillonella	Bacteria;Firmicutes;Clostridia;Clostridiales;Veillonellaceae;Veillonella
Dethiobacter	Bacteria;Firmicutes;Clostridia;Natranaerobiales;Anaerobrancaceae;Dethiobacter
Moorella	Bacteria;Firmicutes;Clostridia;Thermoanaerobacterales;Thermoanaerobacteraceae;Moorella
Thermoanaerobacter	Bacteria;Firmicutes;Clostridia;Thermoanaerobacterales;Thermoanaerobacteraceae;Thermoanaerobacter
Cetobacterium	Bacteria;Fusobacteria;Fusobacteria (class);Fusobacteriales;Fusobacteriaceae;Cetobacterium
Fusobacterium	Bacteria;Fusobacteria;Fusobacteria (class);Fusobacteriales;Fusobacteriaceae;Fusobacterium
J2-29	Bacteria;Fusobacteria;Fusobacteria (class);Fusobacteriales;Fusobacteriaceae;J2-29
Leptotrichia	Bacteria;Fusobacteria;Fusobacteria (class);Fusobacteriales;Fusobacteriaceae;Leptotrichia
Propionigenium	Bacteria;Fusobacteria;Fusobacteria (class);Fusobacteriales;Fusobacteriaceae;Propionigenium
Sebaldella	Bacteria;Fusobacteria;Fusobacteria (class);Fusobacteriales;Fusobacteriaceae;Sebaldella
Sneathia	Bacteria;Fusobacteria;Fusobacteria (class);Fusobacteriales;Fusobacteriaceae;Sneathia
Streptobacillus	Bacteria;Fusobacteria;Fusobacteria (class);Fusobacteriales;Fusobacteriaceae;Streptobacillus
u114	Bacteria;Fusobacteria;Fusobacteria (class);Fusobacteriales;Fusobacteriaceae;u114
Gemmatimonas	Bacteria;Gemmatimonadetes;Gemmatimonadetes (class);Gemmatimonadales;Gemmatimonadaceae;Gemmatimonas
Nitrospira	Bacteria;Nitrospirae;Nitrospira (class);Nitrospirales;Nitrospiraceae;Nitrospira
Gemmata	Bacteria;Planctomycetes;Planctomycea;Gemmatales;Gemmataceae;Gemmata
A17	Bacteria;Planctomycetes;Planctomycea;Pirellulales;Pirellulaceae;A17
Pirellula	Bacteria;Planctomycetes;Planctomycea;Pirellulales;Pirellulaceae;Pirellula
Rhodopirellula	Bacteria;Planctomycetes;Planctomycea;Pirellulales;Unknown;Rhodopirellula
Planctomyces	Bacteria;Planctomycetes;Planctomycea;Planctomycetales;Planctomycetaceae;Planctomyces
Asticcacaulis	Bacteria;Proteobacteria;Alphaproteobacteria;Caulobacterales;Caulobacteraceae;Asticcacaulis
Brevundimonas	Bacteria;Proteobacteria;Alphaproteobacteria;Caulobacterales;Caulobacteraceae;Brevundimonas
Caulobacter	Bacteria;Proteobacteria;Alphaproteobacteria;Caulobacterales;Caulobacteraceae;Caulobacter
Bacteria_Proteobacteria_Alphaproteobacteria_Caulobacterales_Caulobacteraceae_Mycoplana	Bacteria;Proteobacteria;Alphaproteobacteria;Caulobacterales;Caulobacteraceae;Mycoplana
Phenylobacterium	Bacteria;Proteobacteria;Alphaproteobacteria;Caulobacterales;Caulobacteraceae;Phenylobacterium
Aurantimonas	Bacteria;Proteobacteria;Alphaproteobacteria;Rhizobiales;Aurantimonadaceae;Aurantimonas
Chelatococcus	Bacteria;Proteobacteria;Alphaproteobacteria;Rhizobiales;Beijerinckiaceae;Chelatococcus
Afipia	Bacteria;Proteobacteria;Alphaproteobacteria;Rhizobiales;Bradyrhizobiaceae;Afipia
Balneimonas	Bacteria;Proteobacteria;Alphaproteobacteria;Rhizobiales;Bradyrhizobiaceae;Balneimonas
Bosea	Bacteria;Proteobacteria;Alphaproteobacteria;Rhizobiales;Bradyrhizobiaceae;Bosea
Bradyrhizobium	Bacteria;Proteobacteria;Alphaproteobacteria;Rhizobiales;Bradyrhizobiaceae;Bradyrhizobium
Nitrobacter	Bacteria;Proteobacteria;Alphaproteobacteria;Rhizobiales;Bradyrhizobiaceae;Nitrobacter
Rhodopseudomonas	Bacteria;Proteobacteria;Alphaproteobacteria;Rhizobiales;Bradyrhizobiaceae;Rhodopseudomonas
Ochrobactrum	Bacteria;Proteobacteria;Alphaproteobacteria;Rhizobiales;Brucellaceae;Ochrobactrum
Pseudochrobactrum	Bacteria;Proteobacteria;Alphaproteobacteria;Rhizobiales;Brucellaceae;Pseudochrobactrum
Devosia	Bacteria;Proteobacteria;Alphaproteobacteria;Rhizobiales;Hyphomicrobiaceae;Devosia
Hyphomicrobium	Bacteria;Proteobacteria;Alphaproteobacteria;Rhizobiales;Hyphomicrobiaceae;Hyphomicrobium
Pedomicrobium	Bacteria;Proteobacteria;Alphaproteobacteria;Rhizobiales;Hyphomicrobiaceae;Pedomicrobium
Rhodomicrobium	Bacteria;Proteobacteria;Alphaproteobacteria;Rhizobiales;Hyphomicrobiaceae;Rhodomicrobium
Rhodoplanes	Bacteria;Proteobacteria;Alphaproteobacteria;Rhizobiales;Hyphomicrobiaceae;Rhodoplanes
Methylobacterium	Bacteria;Proteobacteria;Alphaproteobacteria;Rhizobiales;Methylobacteriaceae;Methylobacterium
Methylocystis	Bacteria;Proteobacteria;Alphaproteobacteria;Rhizobiales;Methylocystaceae;Methylocystis
Methylopila	Bacteria;Proteobacteria;Alphaproteobacteria;Rhizobiales;Methylocystaceae;Methylopila
Methylosinus	Bacteria;Proteobacteria;Alphaproteobacteria;Rhizobiales;Methylocystaceae;Methylosinus
Pleomorphomonas	Bacteria;Proteobacteria;Alphaproteobacteria;Rhizobiales;Methylocystaceae;Pleomorphomonas
Chelativorans	Bacteria;Proteobacteria;Alphaproteobacteria;Rhizobiales;Phyllobacteriaceae;Chelativorans
Mesorhizobium	Bacteria;Proteobacteria;Alphaproteobacteria;Rhizobiales;Phyllobacteriaceae;Mesorhizobium
Phyllobacterium	Bacteria;Proteobacteria;Alphaproteobacteria;Rhizobiales;Phyllobacteriaceae;Phyllobacterium
Agrobacterium	Bacteria;Proteobacteria;Alphaproteobacteria;Rhizobiales;Rhizobiaceae;Agrobacterium
Ensifer	Bacteria;Proteobacteria;Alphaproteobacteria;Rhizobiales;Rhizobiaceae;Ensifer
Kaistia	Bacteria;Proteobacteria;Alphaproteobacteria;Rhizobiales;Rhizobiaceae;Kaistia
Martelella	Bacteria;Proteobacteria;Alphaproteobacteria;Rhizobiales;Rhizobiaceae;Martelella
Bacteria_Proteobacteria_Alphaproteobacteria_Rhizobiales_Rhizobiaceae_Mycoplana	Bacteria;Proteobacteria;Alphaproteobacteria;Rhizobiales;Rhizobiaceae;Mycoplana
Rhizobium	Bacteria;Proteobacteria;Alphaproteobacteria;Rhizobiales;Rhizobiaceae;Rhizobium
Shinella	Bacteria;Proteobacteria;Alphaproteobacteria;Rhizobiales;Rhizobiaceae;Shinella
Rhodobium	Bacteria;Proteobacteria;Alphaproteobacteria;Rhizobiales;Rhodobiaceae;Rhodobium
Nordella	Bacteria;Proteobacteria;Alphaproteobacteria;Rhizobiales;Unknown;Nordella
Azorhizobium	Bacteria;Proteobacteria;Alphaproteobacteria;Rhizobiales;Xanthobacteraceae;Azorhizobium
Labrys	Bacteria;Proteobacteria;Alphaproteobacteria;Rhizobiales;Xanthobacteraceae;Labrys
Xanthobacter	Bacteria;Proteobacteria;Alphaproteobacteria;Rhizobiales;Xanthobacteraceae;Xanthobacter
Amaricoccus	Bacteria;Proteobacteria;Alphaproteobacteria;Rhodobacterales;Rhodobacteraceae;Amaricoccus
Haematobacter	Bacteria;Proteobacteria;Alphaproteobacteria;Rhodobacterales;Rhodobacteraceae;Haematobacter
Paracoccus	Bacteria;Proteobacteria;Alphaproteobacteria;Rhodobacterales;Rhodobacteraceae;Paracoccus
Rhodobaca	Bacteria;Proteobacteria;Alphaproteobacteria;Rhodobacterales;Rhodobacteraceae;Rhodobaca
Rhodobacter	Bacteria;Proteobacteria;Alphaproteobacteria;Rhodobacterales;Rhodobacteraceae;Rhodobacter
Rubellimicrobium	Bacteria;Proteobacteria;Alphaproteobacteria;Rhodobacterales;Rhodobacteraceae;Rubellimicrobium
Thioclava	Bacteria;Proteobacteria;Alphaproteobacteria;Rhodobacterales;Rhodobacteraceae;Thioclava
Acetobacter	Bacteria;Proteobacteria;Alphaproteobacteria;Rhodospirillales;Acetobacteraceae;Acetobacter
Acidiphilium	Bacteria;Proteobacteria;Alphaproteobacteria;Rhodospirillales;Acetobacteraceae;Acidiphilium
Acidisoma	Bacteria;Proteobacteria;Alphaproteobacteria;Rhodospirillales;Acetobacteraceae;Acidisoma
Acidomonas	Bacteria;Proteobacteria;Alphaproteobacteria;Rhodospirillales;Acetobacteraceae;Acidomonas
Gluconacetobacter	Bacteria;Proteobacteria;Alphaproteobacteria;Rhodospirillales;Acetobacteraceae;Gluconacetobacter
Gluconobacter	Bacteria;Proteobacteria;Alphaproteobacteria;Rhodospirillales;Acetobacteraceae;Gluconobacter
Roseococcus	Bacteria;Proteobacteria;Alphaproteobacteria;Rhodospirillales;Acetobacteraceae;Roseococcus
Roseomonas	Bacteria;Proteobacteria;Alphaproteobacteria;Rhodospirillales;Acetobacteraceae;Roseomonas
Azospirillum	Bacteria;Proteobacteria;Alphaproteobacteria;Rhodospirillales;Rhodospirillaceae;Azospirillum
Inquilinus	Bacteria;Proteobacteria;Alphaproteobacteria;Rhodospirillales;Rhodospirillaceae;Inquilinus
Magnetospirillum	Bacteria;Proteobacteria;Alphaproteobacteria;Rhodospirillales;Rhodospirillaceae;Magnetospirillum
Novispirillum	Bacteria;Proteobacteria;Alphaproteobacteria;Rhodospirillales;Rhodospirillaceae;Novispirillum
Rhodothalassium	Bacteria;Proteobacteria;Alphaproteobacteria;Rhodospirillales;Rhodospirillaceae;Rhodothalassium
Skermanella	Bacteria;Proteobacteria;Alphaproteobacteria;Rhodospirillales;Rhodospirillaceae;Skermanella
Candidatus Odyssella	Bacteria;Proteobacteria;Alphaproteobacteria;Rickettsiales;Unknown;Candidatus Odyssella
Erythromicrobium	Bacteria;Proteobacteria;Alphaproteobacteria;Sphingomonadales;Erythrobacteraceae;Erythromicrobium
Lutibacterium	Bacteria;Proteobacteria;Alphaproteobacteria;Sphingomonadales;Erythrobacteraceae;Lutibacterium
Blastomonas	Bacteria;Proteobacteria;Alphaproteobacteria;Sphingomonadales;Sphingomonadaceae;Blastomonas
Kaistobacter	Bacteria;Proteobacteria;Alphaproteobacteria;Sphingomonadales;Sphingomonadaceae;Kaistobacter
Novosphingobium	Bacteria;Proteobacteria;Alphaproteobacteria;Sphingomonadales;Sphingomonadaceae;Novosphingobium
Sphingobium	Bacteria;Proteobacteria;Alphaproteobacteria;Sphingomonadales;Sphingomonadaceae;Sphingobium
Sphingomonas	Bacteria;Proteobacteria;Alphaproteobacteria;Sphingomonadales;Sphingomonadaceae;Sphingomonas
Sphingopyxis	Bacteria;Proteobacteria;Alphaproteobacteria;Sphingomonadales;Sphingomonadaceae;Sphingopyxis
Achromobacter	Bacteria;Proteobacteria;Betaproteobacteria;Burkholderiales;Alcaligenaceae;Achromobacter
Alcaligenes	Bacteria;Proteobacteria;Betaproteobacteria;Burkholderiales;Alcaligenaceae;Alcaligenes
Azohydromonas	Bacteria;Proteobacteria;Betaproteobacteria;Burkholderiales;Alcaligenaceae;Azohydromonas
Bordetella	Bacteria;Proteobacteria;Betaproteobacteria;Burkholderiales;Alcaligenaceae;Bordetella
Oligella	Bacteria;Proteobacteria;Betaproteobacteria;Burkholderiales;Alcaligenaceae;Oligella
Pelistega	Bacteria;Proteobacteria;Betaproteobacteria;Burkholderiales;Alcaligenaceae;Pelistega
Pigmentiphaga	Bacteria;Proteobacteria;Betaproteobacteria;Burkholderiales;Alcaligenaceae;Pigmentiphaga
Sutterella	Bacteria;Proteobacteria;Betaproteobacteria;Burkholderiales;Alcaligenaceae;Sutterella
Burkholderia	Bacteria;Proteobacteria;Betaproteobacteria;Burkholderiales;Burkholderiaceae;Burkholderia
Cupriavidus	Bacteria;Proteobacteria;Betaproteobacteria;Burkholderiales;Burkholderiaceae;Cupriavidus
Lautropia	Bacteria;Proteobacteria;Betaproteobacteria;Burkholderiales;Burkholderiaceae;Lautropia
Limnobacter	Bacteria;Proteobacteria;Betaproteobacteria;Burkholderiales;Burkholderiaceae;Limnobacter
Pandoraea	Bacteria;Proteobacteria;Betaproteobacteria;Burkholderiales;Burkholderiaceae;Pandoraea
Polynucleobacter	Bacteria;Proteobacteria;Betaproteobacteria;Burkholderiales;Burkholderiaceae;Polynucleobacter
Ralstonia	Bacteria;Proteobacteria;Betaproteobacteria;Burkholderiales;Burkholderiaceae;Ralstonia
Acidovorax	Bacteria;Proteobacteria;Betaproteobacteria;Burkholderiales;Comamonadaceae;Acidovorax
Alicycliphilus	Bacteria;Proteobacteria;Betaproteobacteria;Burkholderiales;Comamonadaceae;Alicycliphilus
Aquamonas	Bacteria;Proteobacteria;Betaproteobacteria;Burkholderiales;Comamonadaceae;Aquamonas
Brachymonas	Bacteria;Proteobacteria;Betaproteobacteria;Burkholderiales;Comamonadaceae;Brachymonas
Caldimonas	Bacteria;Proteobacteria;Betaproteobacteria;Burkholderiales;Comamonadaceae;Caldimonas
Comamonas	Bacteria;Proteobacteria;Betaproteobacteria;Burkholderiales;Comamonadaceae;Comamonas
Curvibacter	Bacteria;Proteobacteria;Betaproteobacteria;Burkholderiales;Comamonadaceae;Curvibacter
Delftia	Bacteria;Proteobacteria;Betaproteobacteria;Burkholderiales;Comamonadaceae;Delftia
Diaphorobacter	Bacteria;Proteobacteria;Betaproteobacteria;Burkholderiales;Comamonadaceae;Diaphorobacter
Giesbergeria	Bacteria;Proteobacteria;Betaproteobacteria;Burkholderiales;Comamonadaceae;Giesbergeria
Hydrogenophaga	Bacteria;Proteobacteria;Betaproteobacteria;Burkholderiales;Comamonadaceae;Hydrogenophaga
Hylemonella	Bacteria;Proteobacteria;Betaproteobacteria;Burkholderiales;Comamonadaceae;Hylemonella
Lampropedia	Bacteria;Proteobacteria;Betaproteobacteria;Burkholderiales;Comamonadaceae;Lampropedia
Limnohabitans	Bacteria;Proteobacteria;Betaproteobacteria;Burkholderiales;Comamonadaceae;Limnohabitans
Polaromonas	Bacteria;Proteobacteria;Betaproteobacteria;Burkholderiales;Comamonadaceae;Polaromonas
Ramlibacter	Bacteria;Proteobacteria;Betaproteobacteria;Burkholderiales;Comamonadaceae;Ramlibacter
Rhodoferax	Bacteria;Proteobacteria;Betaproteobacteria;Burkholderiales;Comamonadaceae;Rhodoferax
Schlegelella	Bacteria;Proteobacteria;Betaproteobacteria;Burkholderiales;Comamonadaceae;Schlegelella
Simplicispira	Bacteria;Proteobacteria;Betaproteobacteria;Burkholderiales;Comamonadaceae;Simplicispira
Variovorax	Bacteria;Proteobacteria;Betaproteobacteria;Burkholderiales;Comamonadaceae;Variovorax
Verminephrobacter	Bacteria;Proteobacteria;Betaproteobacteria;Burkholderiales;Comamonadaceae;Verminephrobacter
Xenophilus	Bacteria;Proteobacteria;Betaproteobacteria;Burkholderiales;Comamonadaceae;Xenophilus
Collimonas	Bacteria;Proteobacteria;Betaproteobacteria;Burkholderiales;Oxalobacteraceae;Collimonas
Herbaspirillum	Bacteria;Proteobacteria;Betaproteobacteria;Burkholderiales;Oxalobacteraceae;Herbaspirillum
Janthinobacterium	Bacteria;Proteobacteria;Betaproteobacteria;Burkholderiales;Oxalobacteraceae;Janthinobacterium
Massilia	Bacteria;Proteobacteria;Betaproteobacteria;Burkholderiales;Oxalobacteraceae;Massilia
Oxalobacter	Bacteria;Proteobacteria;Betaproteobacteria;Burkholderiales;Oxalobacteraceae;Oxalobacter
Paucimonas	Bacteria;Proteobacteria;Betaproteobacteria;Burkholderiales;Oxalobacteraceae;Paucimonas
Aquabacterium	Bacteria;Proteobacteria;Betaproteobacteria;Burkholderiales;Unknown;Aquabacterium
Ideonella	Bacteria;Proteobacteria;Betaproteobacteria;Burkholderiales;Unknown;Ideonella
Leptothrix	Bacteria;Proteobacteria;Betaproteobacteria;Burkholderiales;Unknown;Leptothrix
Methylibium	Bacteria;Proteobacteria;Betaproteobacteria;Burkholderiales;Unknown;Methylibium
Mitsuaria	Bacteria;Proteobacteria;Betaproteobacteria;Burkholderiales;Unknown;Mitsuaria
Paucibacter	Bacteria;Proteobacteria;Betaproteobacteria;Burkholderiales;Unknown;Paucibacter
Roseateles	Bacteria;Proteobacteria;Betaproteobacteria;Burkholderiales;Unknown;Roseateles
Rubrivivax	Bacteria;Proteobacteria;Betaproteobacteria;Burkholderiales;Unknown;Rubrivivax
Sphaerotilus	Bacteria;Proteobacteria;Betaproteobacteria;Burkholderiales;Unknown;Sphaerotilus
Tepidimonas	Bacteria;Proteobacteria;Betaproteobacteria;Burkholderiales;Unknown;Tepidimonas
Thiomonas	Bacteria;Proteobacteria;Betaproteobacteria;Burkholderiales;Unknown;Thiomonas
Gallionella	Bacteria;Proteobacteria;Betaproteobacteria;Gallionellales;Gallionellaceae;Gallionella
Hydrogenophilus	Bacteria;Proteobacteria;Betaproteobacteria;Hydrogenophilales;Hydrogenophilaceae;Hydrogenophilus
Methylobacillus	Bacteria;Proteobacteria;Betaproteobacteria;Methylophilales;Methylophilaceae;Methylobacillus
Methylophilus	Bacteria;Proteobacteria;Betaproteobacteria;Methylophilales;Methylophilaceae;Methylophilus
Methylotenera	Bacteria;Proteobacteria;Betaproteobacteria;Methylophilales;Methylophilaceae;Methylotenera
Methylovorus	Bacteria;Proteobacteria;Betaproteobacteria;Methylophilales;Methylophilaceae;Methylovorus
Alysiella	Bacteria;Proteobacteria;Betaproteobacteria;Neisseriales;Neisseriaceae;Alysiella
Aquitalea	Bacteria;Proteobacteria;Betaproteobacteria;Neisseriales;Neisseriaceae;Aquitalea
Bergeriella	Bacteria;Proteobacteria;Betaproteobacteria;Neisseriales;Neisseriaceae;Bergeriella
Chromobacterium	Bacteria;Proteobacteria;Betaproteobacteria;Neisseriales;Neisseriaceae;Chromobacterium
Conchiformibius	Bacteria;Proteobacteria;Betaproteobacteria;Neisseriales;Neisseriaceae;Conchiformibius
Eikenella	Bacteria;Proteobacteria;Betaproteobacteria;Neisseriales;Neisseriaceae;Eikenella
Kingella	Bacteria;Proteobacteria;Betaproteobacteria;Neisseriales;Neisseriaceae;Kingella
Laribacter	Bacteria;Proteobacteria;Betaproteobacteria;Neisseriales;Neisseriaceae;Laribacter
Neisseria	Bacteria;Proteobacteria;Betaproteobacteria;Neisseriales;Neisseriaceae;Neisseria
Simonsiella	Bacteria;Proteobacteria;Betaproteobacteria;Neisseriales;Neisseriaceae;Simonsiella
Vitreoscilla	Bacteria;Proteobacteria;Betaproteobacteria;Neisseriales;Neisseriaceae;Vitreoscilla
Vogesella	Bacteria;Proteobacteria;Betaproteobacteria;Neisseriales;Neisseriaceae;Vogesella
Nitrosomonas	Bacteria;Proteobacteria;Betaproteobacteria;Nitrosomonadales;Nitrosomonadaceae;Nitrosomonas
Nitrosospira	Bacteria;Proteobacteria;Betaproteobacteria;Nitrosomonadales;Nitrosomonadaceae;Nitrosospira
Procabacter	Bacteria;Proteobacteria;Betaproteobacteria;Procabacteriales;Procabacteriaceae;Procabacter
Azoarcus	Bacteria;Proteobacteria;Betaproteobacteria;Rhodocyclales;Rhodocyclaceae;Azoarcus
Dechloromonas	Bacteria;Proteobacteria;Betaproteobacteria;Rhodocyclales;Rhodocyclaceae;Dechloromonas
Methyloversatilis	Bacteria;Proteobacteria;Betaproteobacteria;Rhodocyclales;Rhodocyclaceae;Methyloversatilis
Rhodocyclus	Bacteria;Proteobacteria;Betaproteobacteria;Rhodocyclales;Rhodocyclaceae;Rhodocyclus
Thauera	Bacteria;Proteobacteria;Betaproteobacteria;Rhodocyclales;Rhodocyclaceae;Thauera
Zoogloea	Bacteria;Proteobacteria;Betaproteobacteria;Rhodocyclales;Rhodocyclaceae;Zoogloea
Bacteriovorax	Bacteria;Proteobacteria;Deltaproteobacteria;Bdellovibrionales;Bacteriovoracaceae;Bacteriovorax
Bdellovibrio	Bacteria;Proteobacteria;Deltaproteobacteria;Bdellovibrionales;Bdellovibrionaceae;Bdellovibrio
Desulfobulbus	Bacteria;Proteobacteria;Deltaproteobacteria;Desulfobacterales;Desulfobulbaceae;Desulfobulbus
Desulfocapsa	Bacteria;Proteobacteria;Deltaproteobacteria;Desulfobacterales;Desulfobulbaceae;Desulfocapsa
Desulfomicrobium	Bacteria;Proteobacteria;Deltaproteobacteria;Desulfovibrionales;Desulfomicrobiaceae;Desulfomicrobium
Desulfonatronum	Bacteria;Proteobacteria;Deltaproteobacteria;Desulfovibrionales;Desulfonatronumaceae;Desulfonatronum
Bilophila	Bacteria;Proteobacteria;Deltaproteobacteria;Desulfovibrionales;Desulfovibrionaceae;Bilophila
Desulfovibrio	Bacteria;Proteobacteria;Deltaproteobacteria;Desulfovibrionales;Desulfovibrionaceae;Desulfovibrio
Lawsonia	Bacteria;Proteobacteria;Deltaproteobacteria;Desulfovibrionales;Desulfovibrionaceae;Lawsonia
Desulfuromonas	Bacteria;Proteobacteria;Deltaproteobacteria;Desulfuromonadales;Desulfuromonadaceae;Desulfuromonas
Geobacter	Bacteria;Proteobacteria;Deltaproteobacteria;Desulfuromonadales;Geobacteraceae;Geobacter
Pelobacter	Bacteria;Proteobacteria;Deltaproteobacteria;Desulfuromonadales;Pelobacteraceae;Pelobacter
Candidatus Entotheonella	Bacteria;Proteobacteria;Deltaproteobacteria;Entotheonellales;Entotheonellaceae;Candidatus Entotheonella
Stigmatella	Bacteria;Proteobacteria;Deltaproteobacteria;Myxococcales;Cystobacteraceae;Stigmatella
Corallococcus	Bacteria;Proteobacteria;Deltaproteobacteria;Myxococcales;Myxococcaceae;Corallococcus
Nannocystis	Bacteria;Proteobacteria;Deltaproteobacteria;Myxococcales;Nannocystaceae;Nannocystis
Desulfobacterium	Bacteria;Proteobacteria;Deltaproteobacteria;Syntrophobacterales;Desulfobacteraceae;Desulfobacterium
Desulfococcus	Bacteria;Proteobacteria;Deltaproteobacteria;Syntrophobacterales;Desulfobacteraceae;Desulfococcus
Syntrophobacter	Bacteria;Proteobacteria;Deltaproteobacteria;Syntrophobacterales;Syntrophobacteraceae;Syntrophobacter
Arcobacter	Bacteria;Proteobacteria;Epsilonproteobacteria;Campylobacterales;Campylobacteraceae;Arcobacter
Campylobacter	Bacteria;Proteobacteria;Epsilonproteobacteria;Campylobacterales;Campylobacteraceae;Campylobacter
Sulfurospirillum	Bacteria;Proteobacteria;Epsilonproteobacteria;Campylobacterales;Campylobacteraceae;Sulfurospirillum
Flexispira	Bacteria;Proteobacteria;Epsilonproteobacteria;Campylobacterales;Helicobacteraceae;Flexispira
Helicobacter	Bacteria;Proteobacteria;Epsilonproteobacteria;Campylobacterales;Helicobacteraceae;Helicobacter
Sulfurimonas	Bacteria;Proteobacteria;Epsilonproteobacteria;Campylobacterales;Helicobacteraceae;Sulfurimonas
Aeromonas	Bacteria;Proteobacteria;Gammaproteobacteria;Aeromonadales;Aeromonadaceae;Aeromonas
Oceanimonas	Bacteria;Proteobacteria;Gammaproteobacteria;Aeromonadales;Aeromonadaceae;Oceanimonas
Oceanisphaera	Bacteria;Proteobacteria;Gammaproteobacteria;Aeromonadales;Aeromonadaceae;Oceanisphaera
Tolumonas	Bacteria;Proteobacteria;Gammaproteobacteria;Aeromonadales;Aeromonadaceae;Tolumonas
Zobellella	Bacteria;Proteobacteria;Gammaproteobacteria;Aeromonadales;Aeromonadaceae;Zobellella
Anaerobiospirillum	Bacteria;Proteobacteria;Gammaproteobacteria;Aeromonadales;Succinivibrionaceae;Anaerobiospirillum
Ruminobacter	Bacteria;Proteobacteria;Gammaproteobacteria;Aeromonadales;Succinivibrionaceae;Ruminobacter
Succinivibrio	Bacteria;Proteobacteria;Gammaproteobacteria;Aeromonadales;Succinivibrionaceae;Succinivibrio
Alishewanella	Bacteria;Proteobacteria;Gammaproteobacteria;Alteromonadales;Alteromonadaceae;Alishewanella
Alteromonas	Bacteria;Proteobacteria;Gammaproteobacteria;Alteromonadales;Alteromonadaceae;Alteromonas
Glaciecola	Bacteria;Proteobacteria;Gammaproteobacteria;Alteromonadales;Alteromonadaceae;Glaciecola
Salinimonas	Bacteria;Proteobacteria;Gammaproteobacteria;Alteromonadales;Alteromonadaceae;Salinimonas
Rheinheimera	Bacteria;Proteobacteria;Gammaproteobacteria;Alteromonadales;Chromatiaceae;Rheinheimera
Thalassomonas	Bacteria;Proteobacteria;Gammaproteobacteria;Alteromonadales;Colwelliaceae;Thalassomonas
Ferrimonas	Bacteria;Proteobacteria;Gammaproteobacteria;Alteromonadales;Ferrimonadaceae;Ferrimonas
Moritella	Bacteria;Proteobacteria;Gammaproteobacteria;Alteromonadales;Moritellaceae;Moritella
Pseudoalteromonas	Bacteria;Proteobacteria;Gammaproteobacteria;Alteromonadales;Pseudoalteromonadaceae;Pseudoalteromonas
Psychromonas	Bacteria;Proteobacteria;Gammaproteobacteria;Alteromonadales;Psychromonadaceae;Psychromonas
Shewanella	Bacteria;Proteobacteria;Gammaproteobacteria;Alteromonadales;Shewanellaceae;Shewanella
Alkalimonas	Bacteria;Proteobacteria;Gammaproteobacteria;Alteromonadales;Unknown;Alkalimonas
Cardiobacterium	Bacteria;Proteobacteria;Gammaproteobacteria;Cardiobacteriales;Cardiobacteriaceae;Cardiobacterium
Allochromatium	Bacteria;Proteobacteria;Gammaproteobacteria;Chromatiales;Chromatiaceae;Allochromatium
Halochromatium	Bacteria;Proteobacteria;Gammaproteobacteria;Chromatiales;Chromatiaceae;Halochromatium
Thiococcus	Bacteria;Proteobacteria;Gammaproteobacteria;Chromatiales;Chromatiaceae;Thiococcus
Thiorhodovibrio	Bacteria;Proteobacteria;Gammaproteobacteria;Chromatiales;Chromatiaceae;Thiorhodovibrio
Thioalkalivibrio	Bacteria;Proteobacteria;Gammaproteobacteria;Chromatiales;Ectothiorhodospiraceae;Thioalkalivibrio
Thiorhodospira	Bacteria;Proteobacteria;Gammaproteobacteria;Chromatiales;Ectothiorhodospiraceae;Thiorhodospira
Steroidobacter	Bacteria;Proteobacteria;Gammaproteobacteria;Chromatiales;Sinobacteraceae;Steroidobacter
Achromatium	Bacteria;Proteobacteria;Gammaproteobacteria;Chromatiales;Thiotrichaceae;Achromatium
Thiohalomonas	Bacteria;Proteobacteria;Gammaproteobacteria;Chromatiales;Unknown;Thiohalomonas
Arsenophonus	Bacteria;Proteobacteria;Gammaproteobacteria;Enterobacteriales;Enterobacteriaceae;Arsenophonus
Averyella	Bacteria;Proteobacteria;Gammaproteobacteria;Enterobacteriales;Enterobacteriaceae;Averyella
Brenneria	Bacteria;Proteobacteria;Gammaproteobacteria;Enterobacteriales;Enterobacteriaceae;Brenneria
Buchnera	Bacteria;Proteobacteria;Gammaproteobacteria;Enterobacteriales;Enterobacteriaceae;Buchnera
Buttiauxella	Bacteria;Proteobacteria;Gammaproteobacteria;Enterobacteriales;Enterobacteriaceae;Buttiauxella
Candidatus Blochmannia	Bacteria;Proteobacteria;Gammaproteobacteria;Enterobacteriales;Enterobacteriaceae;Candidatus Blochmannia
Candidatus Phlomobacter	Bacteria;Proteobacteria;Gammaproteobacteria;Enterobacteriales;Enterobacteriaceae;Candidatus Phlomobacter
Candidatus Regiella	Bacteria;Proteobacteria;Gammaproteobacteria;Enterobacteriales;Enterobacteriaceae;Candidatus Regiella
Cedecea	Bacteria;Proteobacteria;Gammaproteobacteria;Enterobacteriales;Enterobacteriaceae;Cedecea
Citrobacter	Bacteria;Proteobacteria;Gammaproteobacteria;Enterobacteriales;Enterobacteriaceae;Citrobacter
Cronobacter	Bacteria;Proteobacteria;Gammaproteobacteria;Enterobacteriales;Enterobacteriaceae;Cronobacter
Dickeya	Bacteria;Proteobacteria;Gammaproteobacteria;Enterobacteriales;Enterobacteriaceae;Dickeya
Edwardsiella	Bacteria;Proteobacteria;Gammaproteobacteria;Enterobacteriales;Enterobacteriaceae;Edwardsiella
Enterobacter	Bacteria;Proteobacteria;Gammaproteobacteria;Enterobacteriales;Enterobacteriaceae;Enterobacter
Erwinia	Bacteria;Proteobacteria;Gammaproteobacteria;Enterobacteriales;Enterobacteriaceae;Erwinia
Escherichia	Bacteria;Proteobacteria;Gammaproteobacteria;Enterobacteriales;Enterobacteriaceae;Escherichia
Ewingella	Bacteria;Proteobacteria;Gammaproteobacteria;Enterobacteriales;Enterobacteriaceae;Ewingella
Klebsiella	Bacteria;Proteobacteria;Gammaproteobacteria;Enterobacteriales;Enterobacteriaceae;Klebsiella
Leclercia	Bacteria;Proteobacteria;Gammaproteobacteria;Enterobacteriales;Enterobacteriaceae;Leclercia
Morganella	Bacteria;Proteobacteria;Gammaproteobacteria;Enterobacteriales;Enterobacteriaceae;Morganella
Pantoea	Bacteria;Proteobacteria;Gammaproteobacteria;Enterobacteriales;Enterobacteriaceae;Pantoea
Photorhabdus	Bacteria;Proteobacteria;Gammaproteobacteria;Enterobacteriales;Enterobacteriaceae;Photorhabdus
Plesiomonas	Bacteria;Proteobacteria;Gammaproteobacteria;Enterobacteriales;Enterobacteriaceae;Plesiomonas
Proteus	Bacteria;Proteobacteria;Gammaproteobacteria;Enterobacteriales;Enterobacteriaceae;Proteus
Providencia	Bacteria;Proteobacteria;Gammaproteobacteria;Enterobacteriales;Enterobacteriaceae;Providencia
Rahnella	Bacteria;Proteobacteria;Gammaproteobacteria;Enterobacteriales;Enterobacteriaceae;Rahnella
Raoultella	Bacteria;Proteobacteria;Gammaproteobacteria;Enterobacteriales;Enterobacteriaceae;Raoultella
Salmonella	Bacteria;Proteobacteria;Gammaproteobacteria;Enterobacteriales;Enterobacteriaceae;Salmonella
Serratia	Bacteria;Proteobacteria;Gammaproteobacteria;Enterobacteriales;Enterobacteriaceae;Serratia
Sodalis	Bacteria;Proteobacteria;Gammaproteobacteria;Enterobacteriales;Enterobacteriaceae;Sodalis
Trabulsiella	Bacteria;Proteobacteria;Gammaproteobacteria;Enterobacteriales;Enterobacteriaceae;Trabulsiella
Xenorhabdus	Bacteria;Proteobacteria;Gammaproteobacteria;Enterobacteriales;Enterobacteriaceae;Xenorhabdus
Yersinia	Bacteria;Proteobacteria;Gammaproteobacteria;Enterobacteriales;Enterobacteriaceae;Yersinia
Aquicella	Bacteria;Proteobacteria;Gammaproteobacteria;Legionellales;Coxiellaceae;Aquicella
Coxiella	Bacteria;Proteobacteria;Gammaproteobacteria;Legionellales;Coxiellaceae;Coxiella
Rickettsiella	Bacteria;Proteobacteria;Gammaproteobacteria;Legionellales;Coxiellaceae;Rickettsiella
Legionella	Bacteria;Proteobacteria;Gammaproteobacteria;Legionellales;Legionellaceae;Legionella
Tatlockia	Bacteria;Proteobacteria;Gammaproteobacteria;Legionellales;Legionellaceae;Tatlockia
Crenothrix	Bacteria;Proteobacteria;Gammaproteobacteria;Methylococcales;Crenotrichaceae;Crenothrix
Methylocaldum	Bacteria;Proteobacteria;Gammaproteobacteria;Methylococcales;Methylococcaceae;Methylocaldum
Methylococcus	Bacteria;Proteobacteria;Gammaproteobacteria;Methylococcales;Methylococcaceae;Methylococcus
Methylomonas	Bacteria;Proteobacteria;Gammaproteobacteria;Methylococcales;Methylococcaceae;Methylomonas
Methylosphaera	Bacteria;Proteobacteria;Gammaproteobacteria;Methylococcales;Methylococcaceae;Methylosphaera
Cycloclasticus	Bacteria;Proteobacteria;Gammaproteobacteria;Methylococcales;Piscirickettsiaceae;Cycloclasticus
Alcanivorax	Bacteria;Proteobacteria;Gammaproteobacteria;Oceanospirillales;Alcanivoracaceae;Alcanivorax
Marinobacter	Bacteria;Proteobacteria;Gammaproteobacteria;Oceanospirillales;Alteromonadaceae;Marinobacter
Microbulbifer	Bacteria;Proteobacteria;Gammaproteobacteria;Oceanospirillales;Alteromonadaceae;Microbulbifer
Halomonas	Bacteria;Proteobacteria;Gammaproteobacteria;Oceanospirillales;Halomonadaceae;Halomonas
Kushneria	Bacteria;Proteobacteria;Gammaproteobacteria;Oceanospirillales;Halomonadaceae;Kushneria
Amphritea	Bacteria;Proteobacteria;Gammaproteobacteria;Oceanospirillales;Oceanospirillaceae;Amphritea
Marinobacterium	Bacteria;Proteobacteria;Gammaproteobacteria;Oceanospirillales;Oceanospirillaceae;Marinobacterium
Neptunomonas	Bacteria;Proteobacteria;Gammaproteobacteria;Oceanospirillales;Oceanospirillaceae;Neptunomonas
Azorhizophilus	Bacteria;Proteobacteria;Gammaproteobacteria;Oceanospirillales;Pseudomonadaceae;Azorhizophilus
Azotobacter	Bacteria;Proteobacteria;Gammaproteobacteria;Oceanospirillales;Pseudomonadaceae;Azotobacter
Cellvibrio	Bacteria;Proteobacteria;Gammaproteobacteria;Oceanospirillales;Pseudomonadaceae;Cellvibrio
Pseudomonas	Bacteria;Proteobacteria;Gammaproteobacteria;Oceanospirillales;Pseudomonadaceae;Pseudomonas
Congregibacter	Bacteria;Proteobacteria;Gammaproteobacteria;Oceanospirillales;Unknown;Congregibacter
Bacteria_Proteobacteria_Gammaproteobacteria_Oceanospirillales_Unknown_Kangiella	Bacteria;Proteobacteria;Gammaproteobacteria;Oceanospirillales;Unknown;Kangiella
Reinekea	Bacteria;Proteobacteria;Gammaproteobacteria;Oceanospirillales;Unknown;Reinekea
Teredinibacter	Bacteria;Proteobacteria;Gammaproteobacteria;Oceanospirillales;Unknown;Teredinibacter
Actinobacillus	Bacteria;Proteobacteria;Gammaproteobacteria;Pasteurellales;Pasteurellaceae;Actinobacillus
Aggregatibacter	Bacteria;Proteobacteria;Gammaproteobacteria;Pasteurellales;Pasteurellaceae;Aggregatibacter
Avibacterium	Bacteria;Proteobacteria;Gammaproteobacteria;Pasteurellales;Pasteurellaceae;Avibacterium
Basfia	Bacteria;Proteobacteria;Gammaproteobacteria;Pasteurellales;Pasteurellaceae;Basfia
Bibersteinia	Bacteria;Proteobacteria;Gammaproteobacteria;Pasteurellales;Pasteurellaceae;Bibersteinia
Chelonobacter	Bacteria;Proteobacteria;Gammaproteobacteria;Pasteurellales;Pasteurellaceae;Chelonobacter
Gallibacterium	Bacteria;Proteobacteria;Gammaproteobacteria;Pasteurellales;Pasteurellaceae;Gallibacterium
Haemophilus	Bacteria;Proteobacteria;Gammaproteobacteria;Pasteurellales;Pasteurellaceae;Haemophilus
Histophilus	Bacteria;Proteobacteria;Gammaproteobacteria;Pasteurellales;Pasteurellaceae;Histophilus
Mannheimia	Bacteria;Proteobacteria;Gammaproteobacteria;Pasteurellales;Pasteurellaceae;Mannheimia
Pasteurella	Bacteria;Proteobacteria;Gammaproteobacteria;Pasteurellales;Pasteurellaceae;Pasteurella
Volucribacter	Bacteria;Proteobacteria;Gammaproteobacteria;Pasteurellales;Pasteurellaceae;Volucribacter
Acinetobacter	Bacteria;Proteobacteria;Gammaproteobacteria;Pseudomonadales;Moraxellaceae;Acinetobacter
Alkanindiges	Bacteria;Proteobacteria;Gammaproteobacteria;Pseudomonadales;Moraxellaceae;Alkanindiges
Moraxella	Bacteria;Proteobacteria;Gammaproteobacteria;Pseudomonadales;Moraxellaceae;Moraxella
Psychrobacter	Bacteria;Proteobacteria;Gammaproteobacteria;Pseudomonadales;Moraxellaceae;Psychrobacter
Methylophaga	Bacteria;Proteobacteria;Gammaproteobacteria;Thiotrichales;Piscirickettsiaceae;Methylophaga
Leucothrix	Bacteria;Proteobacteria;Gammaproteobacteria;Thiotrichales;Thiotrichaceae;Leucothrix
Thiothrix	Bacteria;Proteobacteria;Gammaproteobacteria;Thiotrichales;Thiotrichaceae;Thiothrix
Bacteria_Proteobacteria_Gammaproteobacteria_Unknown_Unknown_Kangiella	Bacteria;Proteobacteria;Gammaproteobacteria;Unknown;Unknown;Kangiella
Photobacterium	Bacteria;Proteobacteria;Gammaproteobacteria;Vibrionales;Vibrionaceae;Photobacterium
Salinivibrio	Bacteria;Proteobacteria;Gammaproteobacteria;Vibrionales;Vibrionaceae;Salinivibrio
Vibrio	Bacteria;Proteobacteria;Gammaproteobacteria;Vibrionales;Vibrionaceae;Vibrio
Hydrocarboniphaga	Bacteria;Proteobacteria;Gammaproteobacteria;Xanthomonadales;Sinobacteraceae;Hydrocarboniphaga
Aquimonas	Bacteria;Proteobacteria;Gammaproteobacteria;Xanthomonadales;Xanthomonadaceae;Aquimonas
Frateuria	Bacteria;Proteobacteria;Gammaproteobacteria;Xanthomonadales;Xanthomonadaceae;Frateuria
Ignatzschineria	Bacteria;Proteobacteria;Gammaproteobacteria;Xanthomonadales;Xanthomonadaceae;Ignatzschineria
Luteibacter	Bacteria;Proteobacteria;Gammaproteobacteria;Xanthomonadales;Xanthomonadaceae;Luteibacter
Luteimonas	Bacteria;Proteobacteria;Gammaproteobacteria;Xanthomonadales;Xanthomonadaceae;Luteimonas
Lysobacter	Bacteria;Proteobacteria;Gammaproteobacteria;Xanthomonadales;Xanthomonadaceae;Lysobacter
Pseudoxanthomonas	Bacteria;Proteobacteria;Gammaproteobacteria;Xanthomonadales;Xanthomonadaceae;Pseudoxanthomonas
Stenotrophomonas	Bacteria;Proteobacteria;Gammaproteobacteria;Xanthomonadales;Xanthomonadaceae;Stenotrophomonas
Thermomonas	Bacteria;Proteobacteria;Gammaproteobacteria;Xanthomonadales;Xanthomonadaceae;Thermomonas
Xanthomonas	Bacteria;Proteobacteria;Gammaproteobacteria;Xanthomonadales;Xanthomonadaceae;Xanthomonas
Brachyspira	Bacteria;Spirochaetes;Brachyspirae;Brachyspirales;Brachyspiraceae;Brachyspira
SJA-88	Bacteria;Spirochaetes;Leptospirae;Leptospirales;Leptospiraceae;SJA-88
Treponema	Bacteria;Spirochaetes;Spirochaetes (class);Spirochaetales;Spirochaetaceae;Treponema
Aminiphilus	Bacteria;Synergistetes;Synergistia;Synergistales;Aminiphilaceae;Aminiphilus
Jonquetella	Bacteria;Synergistetes;Synergistia;Synergistales;Dethiosulfovibrionaceae;Jonquetella
Pyramidobacter	Bacteria;Synergistetes;Synergistia;Synergistales;Dethiosulfovibrionaceae;Pyramidobacter
TG5	Bacteria;Synergistetes;Synergistia;Synergistales;Dethiosulfovibrionaceae;TG5
Cloacibacillus	Bacteria;Synergistetes;Synergistia;Synergistales;Synergistaceae;Cloacibacillus
Synergistes	Bacteria;Synergistetes;Synergistia;Synergistales;Synergistaceae;Synergistes
Allobaculum	Bacteria;Tenericutes;Erysipelotrichi;Erysipelotrichales;Erysipelotrichaceae;Allobaculum
Bulleidia	Bacteria;Tenericutes;Erysipelotrichi;Erysipelotrichales;Erysipelotrichaceae;Bulleidia
Catenibacterium	Bacteria;Tenericutes;Erysipelotrichi;Erysipelotrichales;Erysipelotrichaceae;Catenibacterium
Bacteria_Tenericutes_Erysipelotrichi_Erysipelotrichales_Erysipelotrichaceae_Clostridium	Bacteria;Tenericutes;Erysipelotrichi;Erysipelotrichales;Erysipelotrichaceae;Clostridium
Coprobacillus	Bacteria;Tenericutes;Erysipelotrichi;Erysipelotrichales;Erysipelotrichaceae;Coprobacillus
Erysipelothrix	Bacteria;Tenericutes;Erysipelotrichi;Erysipelotrichales;Erysipelotrichaceae;Erysipelothrix
Holdemania	Bacteria;Tenericutes;Erysipelotrichi;Erysipelotrichales;Erysipelotrichaceae;Holdemania
p-75-a5	Bacteria;Tenericutes;Erysipelotrichi;Erysipelotrichales;Erysipelotrichaceae;p-75-a5
PSB-M-3	Bacteria;Tenericutes;Erysipelotrichi;Erysipelotrichales;Erysipelotrichaceae;PSB-M-3
Sharpea	Bacteria;Tenericutes;Erysipelotrichi;Erysipelotrichales;Erysipelotrichaceae;Sharpea
Anaeroplasma	Bacteria;Tenericutes;Mollicutes;Anaeroplasmatales;Anaeroplasmataceae;Anaeroplasma
Asteroleplasma	Bacteria;Tenericutes;Mollicutes;Anaeroplasmatales;Anaeroplasmataceae;Asteroleplasma
Mycoplasma	Bacteria;Tenericutes;Mollicutes;Mycoplasmatales;Mycoplasmataceae;Mycoplasma
Ureaplasma	Bacteria;Tenericutes;Mollicutes;Mycoplasmatales;Mycoplasmataceae;Ureaplasma
RFN20	Bacteria;Tenericutes;Unknown;Unknown;vadinHA31;RFN20
Deinococcus	Bacteria;Thermi;Deinococci;Deinococcales;Deinococcaceae;Deinococcus
Thermus	Bacteria;Thermi;Deinococci;Thermales;Thermaceae;Thermus
Opitutus	Bacteria;Verrucomicrobia;Opitutae;Unknown;Opitutaceae;Opitutus
Chthoniobacter	Bacteria;Verrucomicrobia;Spartobacteria;Unknown;Unknown;Chthoniobacter
Akkermansia	Bacteria;Verrucomicrobia;Verrucomicrobiae;Verrucomicrobiales;Verrucomicrobiaceae;Akkermansia
Luteolibacter	Bacteria;Verrucomicrobia;Verrucomicrobiae;Verrucomicrobiales;Verrucomicrobiaceae;Luteolibacter
Prosthecobacter	Bacteria;Verrucomicrobia;Verrucomicrobiae;Verrucomicrobiales;Verrucomicrobiaceae;Prosthecobacter
Unknown	Unknown;Unknown;Unknown;Unknown;Unknown;Unknown
